00000100000
00001110000
00011111000
00001110000
00001110000
00001110000
00011111000
00011111000
00011111000