111111111111
101100001101
101111111101
100000000001
101111111101
100000000001
101100001101
111111111111
110011110011
000011110000
111111111111