111001001110
110011100111
100111110010
011011101101
011010101100
111010001111
110110010110
010110010101
111111111110
001111100111
111001111100
111111111111
000111001110