110011110011
110110011011
111111111111
011100001110
110001100011
111110011111
111111111111
000111000111
111000111000
111111111111
110011110011
